"filename", "language", "C#", "HTML", "ShaderLab", "CSS", "comment", "blank", "total"
"c:\Users\bobbo\Documents\GitHub\FoodDynasty\Assets\Dynasty\Core\Grid\GridDebugger.cs", "C#", 46, 0, 0, 0, 0, 12, 58
"c:\Users\bobbo\Documents\GitHub\FoodDynasty\Assets\Dynasty\Core\Grid\GridManager.cs", "C#", 163, 0, 0, 0, 31, 49, 243
"c:\Users\bobbo\Documents\GitHub\FoodDynasty\Assets\Dynasty\Core\Grid\GridObject.cs", "C#", 68, 0, 0, 0, 35, 26, 129
"c:\Users\bobbo\Documents\GitHub\FoodDynasty\Assets\Dynasty\Core\Grid\GridOutline.cs", "C#", 38, 0, 0, 0, 0, 11, 49
"c:\Users\bobbo\Documents\GitHub\FoodDynasty\Assets\Dynasty\Core\Grid\GridPreview.cs", "C#", 15, 0, 0, 0, 0, 6, 21
"c:\Users\bobbo\Documents\GitHub\FoodDynasty\Assets\Dynasty\Core\Grid\GridRotation.cs", "C#", 51, 0, 0, 0, 35, 18, 104
"c:\Users\bobbo\Documents\GitHub\FoodDynasty\Assets\Dynasty\Core\Grid\GridSize.cs", "C#", 84, 0, 0, 0, 34, 20, 138
"c:\Users\bobbo\Documents\GitHub\FoodDynasty\Assets\Dynasty\Core\Grid\GridUtil.cs", "C#", 12, 0, 0, 0, 6, 6, 24
"c:\Users\bobbo\Documents\GitHub\FoodDynasty\Assets\Dynasty\Core\Grid\IRangeProvider.cs", "C#", 5, 0, 0, 0, 0, 2, 7
"c:\Users\bobbo\Documents\GitHub\FoodDynasty\Assets\Dynasty\Core\Grid\Interaction\GridExpansion.cs", "C#", 27, 0, 0, 0, 0, 8, 35
"c:\Users\bobbo\Documents\GitHub\FoodDynasty\Assets\Dynasty\Core\Grid\Interaction\GridExpansionController.cs", "C#", 75, 0, 0, 0, 0, 22, 97
"c:\Users\bobbo\Documents\GitHub\FoodDynasty\Assets\Dynasty\Core\Grid\Interaction\GridObjectBuilder.cs", "C#", 35, 0, 0, 0, 9, 12, 56
"c:\Users\bobbo\Documents\GitHub\FoodDynasty\Assets\Dynasty\Core\Grid\Interaction\GridObjectMover.cs", "C#", 48, 0, 0, 0, 3, 13, 64
"c:\Users\bobbo\Documents\GitHub\FoodDynasty\Assets\Dynasty\Core\Grid\Interaction\GridObjectPlacer.cs", "C#", 256, 0, 0, 0, 13, 78, 347
"c:\Users\bobbo\Documents\GitHub\FoodDynasty\Assets\Dynasty\Core\Grid\Interaction\GridObjectSelector.cs", "C#", 59, 0, 0, 0, 3, 19, 81
"c:\Users\bobbo\Documents\GitHub\FoodDynasty\Assets\Dynasty\Core\Grid\Interaction\InventoryGridObjectHandler.cs", "C#", 46, 0, 0, 0, 3, 15, 64
"c:\Users\bobbo\Documents\GitHub\FoodDynasty\Assets\Dynasty\Core\Grid\SerializedGridSize.cs", "C#", 43, 0, 0, 0, 9, 11, 63
"c:\Users\bobbo\Documents\GitHub\FoodDynasty\Assets\Dynasty\Core\Inventory\Data\ItemData.cs", "C#", 68, 0, 0, 0, 3, 17, 88
"c:\Users\bobbo\Documents\GitHub\FoodDynasty\Assets\Dynasty\Core\Inventory\Data\MachineEntity.cs", "C#", 15, 0, 0, 0, 6, 5, 26
"c:\Users\bobbo\Documents\GitHub\FoodDynasty\Assets\Dynasty\Core\Inventory\Data\MachineItemData.cs", "C#", 48, 0, 0, 0, 24, 17, 89
"c:\Users\bobbo\Documents\GitHub\FoodDynasty\Assets\Dynasty\Core\Inventory\Data\ToppingItemData.cs", "C#", 26, 0, 0, 0, 9, 9, 44
"c:\Users\bobbo\Documents\GitHub\FoodDynasty\Assets\Dynasty\Core\Inventory\IOnDeletedHandler.cs", "C#", 5, 0, 0, 0, 7, 2, 14
"c:\Users\bobbo\Documents\GitHub\FoodDynasty\Assets\Dynasty\Core\Inventory\InventoryAsset.cs", "C#", 53, 0, 0, 0, 22, 18, 93
"c:\Users\bobbo\Documents\GitHub\FoodDynasty\Assets\Dynasty\Core\Inventory\Item.cs", "C#", 7, 0, 0, 0, 12, 4, 23
"c:\Users\bobbo\Documents\GitHub\FoodDynasty\Assets\Dynasty\Core\Inventory\ItemSorting.cs", "C#", 39, 0, 0, 0, 3, 8, 50
"c:\Users\bobbo\Documents\GitHub\FoodDynasty\Assets\Dynasty\Core\Inventory\MoneyManager.cs", "C#", 30, 0, 0, 0, 9, 9, 48
"c:\Users\bobbo\Documents\GitHub\FoodDynasty\Assets\Dynasty\Core\Inventory\UnlockManager.cs", "C#", 56, 0, 0, 0, 0, 16, 72
"c:\Users\bobbo\Documents\GitHub\FoodDynasty\Assets\Dynasty\Core\Tooltip\Keybinds.cs", "C#", 18, 0, 0, 0, 0, 5, 23
"c:\Users\bobbo\Documents\GitHub\FoodDynasty\Assets\Dynasty\Core\Tooltip\PopupData.cs", "C#", 41, 0, 0, 0, 0, 9, 50
"c:\Users\bobbo\Documents\GitHub\FoodDynasty\Assets\Dynasty\Core\Tooltip\TooltipData.cs", "C#", 33, 0, 0, 0, 15, 10, 58
"c:\Users\bobbo\Documents\GitHub\FoodDynasty\Assets\Dynasty\Core\Tooltip\TooltipLockAxis.cs", "C#", 9, 0, 0, 0, 0, 3, 12
"c:\Users\bobbo\Documents\GitHub\FoodDynasty\Assets\Dynasty\Core\Tooltip\TooltipParams.cs", "C#", 8, 0, 0, 0, 3, 3, 14
"c:\Users\bobbo\Documents\GitHub\FoodDynasty\Assets\Dynasty\Editor\Drawers\FloatDataPropertyDrawer.cs", "C#", 15, 0, 0, 0, 1, 6, 22
"c:\Users\bobbo\Documents\GitHub\FoodDynasty\Assets\Dynasty\Editor\Drawers\FoodFilterDrawer.cs", "C#", 50, 0, 0, 0, 0, 13, 63
"c:\Users\bobbo\Documents\GitHub\FoodDynasty\Assets\Dynasty\Editor\Drawers\FoodTraitModifierDrawer.cs", "C#", 69, 0, 0, 0, 0, 16, 85
"c:\Users\bobbo\Documents\GitHub\FoodDynasty\Assets\Dynasty\Editor\Drawers\FoodTraitSelectionDrawer.cs", "C#", 72, 0, 0, 0, 0, 25, 97
"c:\Users\bobbo\Documents\GitHub\FoodDynasty\Assets\Dynasty\Editor\Drawers\FoodTraitValueDrawer.cs", "C#", 43, 0, 0, 0, 0, 10, 53
"c:\Users\bobbo\Documents\GitHub\FoodDynasty\Assets\Dynasty\Editor\Drawers\OptionalDrawer.cs", "C#", 24, 0, 0, 0, 0, 6, 30
"c:\Users\bobbo\Documents\GitHub\FoodDynasty\Assets\Dynasty\Editor\Drawers\SerializedGridSizeDrawer.cs", "C#", 83, 0, 0, 0, 0, 27, 110
"c:\Users\bobbo\Documents\GitHub\FoodDynasty\Assets\Dynasty\Editor\Editors\BaseIngredientItemDataEditor.cs", "C#", 32, 0, 0, 0, 0, 8, 40
"c:\Users\bobbo\Documents\GitHub\FoodDynasty\Assets\Dynasty\Editor\Editors\FoodTraitDatabaseEditor.cs", "C#", 44, 0, 0, 0, 2, 15, 61
"c:\Users\bobbo\Documents\GitHub\FoodDynasty\Assets\Dynasty\Editor\Editors\MachineItemDataEditor.cs", "C#", 67, 0, 0, 0, 0, 22, 89
"c:\Users\bobbo\Documents\GitHub\FoodDynasty\Assets\Dynasty\Editor\Editors\MachineLoaderEditor.cs", "C#", 32, 0, 0, 0, 0, 10, 42
"c:\Users\bobbo\Documents\GitHub\FoodDynasty\Assets\Dynasty\Editor\Editors\SaveManagerEditor.cs", "C#", 39, 0, 0, 0, 0, 13, 52
"c:\Users\bobbo\Documents\GitHub\FoodDynasty\Assets\Dynasty\Editor\Editors\ToppingItemDataEditor.cs", "C#", 29, 0, 0, 0, 0, 7, 36
"c:\Users\bobbo\Documents\GitHub\FoodDynasty\Assets\Dynasty\Editor\ItemExplorer\EditorUtil.cs", "C#", 43, 0, 0, 0, 0, 8, 51
"c:\Users\bobbo\Documents\GitHub\FoodDynasty\Assets\Dynasty\Editor\ItemExplorer\ItemCreatorPopupWindow.cs", "C#", 186, 0, 0, 0, 0, 35, 221
"c:\Users\bobbo\Documents\GitHub\FoodDynasty\Assets\Dynasty\Editor\ItemExplorer\ItemCreatorUtil.cs", "C#", 23, 0, 0, 0, 0, 5, 28
"c:\Users\bobbo\Documents\GitHub\FoodDynasty\Assets\Dynasty\Editor\ItemExplorer\ItemExplorer.cs", "C#", 104, 0, 0, 0, 0, 29, 133
"c:\Users\bobbo\Documents\GitHub\FoodDynasty\Assets\Dynasty\Editor\ItemExplorer\ItemMachineEditor.cs", "C#", 183, 0, 0, 0, 0, 49, 232
"c:\Users\bobbo\Documents\GitHub\FoodDynasty\Assets\Dynasty\Editor\ItemExplorer\MachineCreator.cs", "C#", 141, 0, 0, 0, 3, 41, 185
"c:\Users\bobbo\Documents\GitHub\FoodDynasty\Assets\Dynasty\Editor\Material\MaterialIconEditor.cs", "C#", 109, 0, 0, 0, 3, 30, 142
"c:\Users\bobbo\Documents\GitHub\FoodDynasty\Assets\Dynasty\Editor\Material\MaterialIconSelectionWindow.cs", "C#", 267, 0, 0, 0, 0, 64, 331
"c:\Users\bobbo\Documents\GitHub\FoodDynasty\Assets\Dynasty\Editor\Material\MenuOptions.cs", "C#", 35, 0, 0, 0, 0, 9, 44
"c:\Users\bobbo\Documents\GitHub\FoodDynasty\Assets\Dynasty\Editor\Util\SerializedPropertyExtensions.cs", "C#", 110, 0, 0, 0, 8, 15, 133
"c:\Users\bobbo\Documents\GitHub\FoodDynasty\Assets\Dynasty\Editor\Util\ThumbnailCreator.cs", "C#", 84, 0, 0, 0, 0, 25, 109
"c:\Users\bobbo\Documents\GitHub\FoodDynasty\Assets\Dynasty\External\LeanTween\Documentation\assets\css\main.css", "CSS", 0, 0, 0, 610, 79, 148, 837
"c:\Users\bobbo\Documents\GitHub\FoodDynasty\Assets\Dynasty\External\LeanTween\Documentation\assets\index.html", "HTML", 0, 10, 0, 0, 0, 1, 11
"c:\Users\bobbo\Documents\GitHub\FoodDynasty\Assets\Dynasty\External\LeanTween\Documentation\classes\LTBezierPath.html", "HTML", 0, 543, 0, 0, 4, 247, 794
"c:\Users\bobbo\Documents\GitHub\FoodDynasty\Assets\Dynasty\External\LeanTween\Documentation\classes\LTDescr.html", "HTML", 0, 1940, 0, 0, 4, 999, 2943
"c:\Users\bobbo\Documents\GitHub\FoodDynasty\Assets\Dynasty\External\LeanTween\Documentation\classes\LTEvent.html", "HTML", 0, 180, 0, 0, 4, 56, 240
"c:\Users\bobbo\Documents\GitHub\FoodDynasty\Assets\Dynasty\External\LeanTween\Documentation\classes\LTRect.html", "HTML", 0, 267, 0, 0, 4, 91, 362
"c:\Users\bobbo\Documents\GitHub\FoodDynasty\Assets\Dynasty\External\LeanTween\Documentation\classes\LTSeq.html", "HTML", 0, 379, 0, 0, 4, 154, 537
"c:\Users\bobbo\Documents\GitHub\FoodDynasty\Assets\Dynasty\External\LeanTween\Documentation\classes\LTSpline.html", "HTML", 0, 542, 0, 0, 4, 253, 799
"c:\Users\bobbo\Documents\GitHub\FoodDynasty\Assets\Dynasty\External\LeanTween\Documentation\classes\LeanAudio.html", "HTML", 0, 243, 0, 0, 4, 88, 335
"c:\Users\bobbo\Documents\GitHub\FoodDynasty\Assets\Dynasty\External\LeanTween\Documentation\classes\LeanAudioOptions.html", "HTML", 0, 275, 0, 0, 4, 107, 386
"c:\Users\bobbo\Documents\GitHub\FoodDynasty\Assets\Dynasty\External\LeanTween\Documentation\classes\LeanSmooth.html", "HTML", 0, 1357, 0, 0, 4, 600, 1961
"c:\Users\bobbo\Documents\GitHub\FoodDynasty\Assets\Dynasty\External\LeanTween\Documentation\classes\LeanTween.html", "HTML", 0, 5465, 0, 0, 4, 2655, 8124
"c:\Users\bobbo\Documents\GitHub\FoodDynasty\Assets\Dynasty\External\LeanTween\Documentation\classes\LeanTweenType.html", "HTML", 0, 637, 0, 0, 4, 452, 1093
"c:\Users\bobbo\Documents\GitHub\FoodDynasty\Assets\Dynasty\External\LeanTween\Documentation\classes\index.html", "HTML", 0, 10, 0, 0, 0, 1, 11
"c:\Users\bobbo\Documents\GitHub\FoodDynasty\Assets\Dynasty\External\LeanTween\Documentation\elements\index.html", "HTML", 0, 10, 0, 0, 0, 1, 11
"c:\Users\bobbo\Documents\GitHub\FoodDynasty\Assets\Dynasty\External\LeanTween\Documentation\index.html", "HTML", 0, 142, 0, 0, 4, 22, 168
"c:\Users\bobbo\Documents\GitHub\FoodDynasty\Assets\Dynasty\External\LeanTween\Editor\LeanTweenDocumentationEditor.cs", "C#", 48, 0, 0, 0, 2, 9, 59
"c:\Users\bobbo\Documents\GitHub\FoodDynasty\Assets\Dynasty\External\LeanTween\Framework\LTDescr.cs", "C#", 1657, 0, 0, 0, 370, 282, 2309
"c:\Users\bobbo\Documents\GitHub\FoodDynasty\Assets\Dynasty\External\LeanTween\Framework\LTDescrOptional.cs", "C#", 61, 0, 0, 0, 15, 14, 90
"c:\Users\bobbo\Documents\GitHub\FoodDynasty\Assets\Dynasty\External\LeanTween\Framework\LTSeq.cs", "C#", 99, 0, 0, 0, 79, 48, 226
"c:\Users\bobbo\Documents\GitHub\FoodDynasty\Assets\Dynasty\External\LeanTween\Framework\LeanAudio.cs", "C#", 257, 0, 0, 0, 81, 81, 419
"c:\Users\bobbo\Documents\GitHub\FoodDynasty\Assets\Dynasty\External\LeanTween\Framework\LeanSmooth.cs", "C#", 136, 0, 0, 0, 186, 43, 365
"c:\Users\bobbo\Documents\GitHub\FoodDynasty\Assets\Dynasty\External\LeanTween\Framework\LeanTest.cs", "C#", 106, 0, 0, 0, 1, 16, 123
"c:\Users\bobbo\Documents\GitHub\FoodDynasty\Assets\Dynasty\External\LeanTween\Framework\LeanTween.cs", "C#", 2251, 0, 0, 0, 1393, 447, 4091
"c:\Users\bobbo\Documents\GitHub\FoodDynasty\Assets\Dynasty\External\LeanTween\Framework\LeanTweenExt.cs", "C#", 124, 0, 0, 0, 57, 7, 188
"c:\Users\bobbo\Documents\GitHub\FoodDynasty\Assets\Dynasty\External\MaterialIcons\MaterialIcon.cs", "C#", 69, 0, 0, 0, 2, 15, 86
"c:\Users\bobbo\Documents\GitHub\FoodDynasty\Assets\Dynasty\External\QuickOutline\Resources\Shaders\OutlineFill.shader", "ShaderLab", 0, 0, 58, 0, 7, 17, 82
"c:\Users\bobbo\Documents\GitHub\FoodDynasty\Assets\Dynasty\External\QuickOutline\Resources\Shaders\OutlineMask.shader", "ShaderLab", 0, 0, 22, 0, 7, 5, 34
"c:\Users\bobbo\Documents\GitHub\FoodDynasty\Assets\Dynasty\External\QuickOutline\Scripts\Outline.cs", "C#", 196, 0, 0, 0, 39, 78, 313
"c:\Users\bobbo\Documents\GitHub\FoodDynasty\Assets\Dynasty\Food\Data\FoodItemData.cs", "C#", 17, 0, 0, 0, 0, 5, 22
"c:\Users\bobbo\Documents\GitHub\FoodDynasty\Assets\Dynasty\Food\Data\FoodObjectPool.cs", "C#", 17, 0, 0, 0, 0, 5, 22
"c:\Users\bobbo\Documents\GitHub\FoodDynasty\Assets\Dynasty\Food\Data\FoodTraitDatabase.cs", "C#", 73, 0, 0, 0, 0, 20, 93
"c:\Users\bobbo\Documents\GitHub\FoodDynasty\Assets\Dynasty\Food\Data\FoodTraitSelection.cs", "C#", 12, 0, 0, 0, 0, 4, 16
"c:\Users\bobbo\Documents\GitHub\FoodDynasty\Assets\Dynasty\Food\Data\FoodTraitType.cs", "C#", 8, 0, 0, 0, 0, 2, 10
"c:\Users\bobbo\Documents\GitHub\FoodDynasty\Assets\Dynasty\Food\Data\FoodTraitValue.cs", "C#", 24, 0, 0, 0, 0, 6, 30
"c:\Users\bobbo\Documents\GitHub\FoodDynasty\Assets\Dynasty\Food\Filtering\FoodFilter.cs", "C#", 36, 0, 0, 0, 0, 7, 43
"c:\Users\bobbo\Documents\GitHub\FoodDynasty\Assets\Dynasty\Food\Filtering\FoodFilterGroup.cs", "C#", 34, 0, 0, 0, 0, 8, 42
"c:\Users\bobbo\Documents\GitHub\FoodDynasty\Assets\Dynasty\Food\Instance\DefaultModelProvider.cs", "C#", 35, 0, 0, 0, 0, 11, 46
"c:\Users\bobbo\Documents\GitHub\FoodDynasty\Assets\Dynasty\Food\Instance\FoodBehaviour.cs", "C#", 90, 0, 0, 0, 0, 29, 119
"c:\Users\bobbo\Documents\GitHub\FoodDynasty\Assets\Dynasty\Food\Instance\FoodCamera.cs", "C#", 67, 0, 0, 0, 0, 21, 88
"c:\Users\bobbo\Documents\GitHub\FoodDynasty\Assets\Dynasty\Food\Instance\FoodManager.cs", "C#", 45, 0, 0, 0, 0, 15, 60
"c:\Users\bobbo\Documents\GitHub\FoodDynasty\Assets\Dynasty\Food\Instance\ModelProvider.cs", "C#", 29, 0, 0, 0, 0, 8, 37
"c:\Users\bobbo\Documents\GitHub\FoodDynasty\Assets\Dynasty\Food\Instance\ParticleTrigger.cs", "C#", 18, 0, 0, 0, 0, 6, 24
"c:\Users\bobbo\Documents\GitHub\FoodDynasty\Assets\Dynasty\Food\Instance\StabilityBehaviour.cs", "C#", 50, 0, 0, 0, 0, 13, 63
"c:\Users\bobbo\Documents\GitHub\FoodDynasty\Assets\Dynasty\Food\Instance\StackModelProvider.cs", "C#", 47, 0, 0, 0, 0, 16, 63
"c:\Users\bobbo\Documents\GitHub\FoodDynasty\Assets\Dynasty\Food\Modification\FoodModelModifier.cs", "C#", 24, 0, 0, 0, 0, 5, 29
"c:\Users\bobbo\Documents\GitHub\FoodDynasty\Assets\Dynasty\Food\Modification\FoodModifierGroup.cs", "C#", 43, 0, 0, 0, 0, 10, 53
"c:\Users\bobbo\Documents\GitHub\FoodDynasty\Assets\Dynasty\Food\Modification\FoodTraitModifier.cs", "C#", 60, 0, 0, 0, 0, 9, 69
"c:\Users\bobbo\Documents\GitHub\FoodDynasty\Assets\Dynasty\Library\Audio\IdleSound.cs", "C#", 21, 0, 0, 0, 0, 7, 28
"c:\Users\bobbo\Documents\GitHub\FoodDynasty\Assets\Dynasty\Library\Audio\PlayOnGameEvent.cs", "C#", 14, 0, 0, 0, 0, 5, 19
"c:\Users\bobbo\Documents\GitHub\FoodDynasty\Assets\Dynasty\Library\Audio\PlayOnLocalEvent.cs", "C#", 14, 0, 0, 0, 0, 5, 19
"c:\Users\bobbo\Documents\GitHub\FoodDynasty\Assets\Dynasty\Library\Audio\SoundEffect.cs", "C#", 24, 0, 0, 0, 0, 6, 30
"c:\Users\bobbo\Documents\GitHub\FoodDynasty\Assets\Dynasty\Library\Audio\SoundManager.cs", "C#", 118, 0, 0, 0, 0, 27, 145
"c:\Users\bobbo\Documents\GitHub\FoodDynasty\Assets\Dynasty\Library\Audio\UISounds.cs", "C#", 30, 0, 0, 0, 0, 8, 38
"c:\Users\bobbo\Documents\GitHub\FoodDynasty\Assets\Dynasty\Library\Classes\CoroutineHandle.cs", "C#", 20, 0, 0, 0, 0, 7, 27
"c:\Users\bobbo\Documents\GitHub\FoodDynasty\Assets\Dynasty\Library\Classes\Modifier.cs", "C#", 101, 0, 0, 0, 0, 17, 118
"c:\Users\bobbo\Documents\GitHub\FoodDynasty\Assets\Dynasty\Library\Classes\Optional.cs", "C#", 16, 0, 0, 0, 0, 5, 21
"c:\Users\bobbo\Documents\GitHub\FoodDynasty\Assets\Dynasty\Library\Classes\Singleton.cs", "C#", 29, 0, 0, 0, 0, 9, 38
"c:\Users\bobbo\Documents\GitHub\FoodDynasty\Assets\Dynasty\Library\Data\DataObject.cs", "C#", 7, 0, 0, 0, 3, 3, 13
"c:\Users\bobbo\Documents\GitHub\FoodDynasty\Assets\Dynasty\Library\Data\IAdditionalSaveData.cs", "C#", 13, 0, 0, 0, 16, 7, 36
"c:\Users\bobbo\Documents\GitHub\FoodDynasty\Assets\Dynasty\Library\Data\IDataProvider.cs", "C#", 5, 0, 0, 0, 3, 2, 10
"c:\Users\bobbo\Documents\GitHub\FoodDynasty\Assets\Dynasty\Library\Data\IPrefabProvider.cs", "C#", 7, 0, 0, 0, 3, 3, 13
"c:\Users\bobbo\Documents\GitHub\FoodDynasty\Assets\Dynasty\Library\Data\SerializedDataObject.cs", "C#", 12, 0, 0, 0, 3, 4, 19
"c:\Users\bobbo\Documents\GitHub\FoodDynasty\Assets\Dynasty\Library\Entity\Entity.cs", "C#", 9, 0, 0, 0, 4, 3, 16
"c:\Users\bobbo\Documents\GitHub\FoodDynasty\Assets\Dynasty\Library\Entity\EntityInfo.cs", "C#", 24, 0, 0, 0, 0, 7, 31
"c:\Users\bobbo\Documents\GitHub\FoodDynasty\Assets\Dynasty\Library\Entity\IEntityData.cs", "C#", 9, 0, 0, 0, 0, 3, 12
"c:\Users\bobbo\Documents\GitHub\FoodDynasty\Assets\Dynasty\Library\Entity\IInfoProvider.cs", "C#", 6, 0, 0, 0, 0, 3, 9
"c:\Users\bobbo\Documents\GitHub\FoodDynasty\Assets\Dynasty\Library\Entity\IStatusProvider.cs", "C#", 8, 0, 0, 0, 0, 3, 11
"c:\Users\bobbo\Documents\GitHub\FoodDynasty\Assets\Dynasty\Library\Events\CheckEvent.cs", "C#", 16, 0, 0, 0, 0, 6, 22
"c:\Users\bobbo\Documents\GitHub\FoodDynasty\Assets\Dynasty\Library\Events\Condition.cs", "C#", 11, 0, 0, 0, 0, 4, 15
"c:\Users\bobbo\Documents\GitHub\FoodDynasty\Assets\Dynasty\Library\Events\Event.cs", "C#", 11, 0, 0, 0, 0, 4, 15
"c:\Users\bobbo\Documents\GitHub\FoodDynasty\Assets\Dynasty\Library\Events\GameEvent.cs", "C#", 18, 0, 0, 0, 0, 6, 24
"c:\Users\bobbo\Documents\GitHub\FoodDynasty\Assets\Dynasty\Library\Events\GenericEvent.cs", "C#", 11, 0, 0, 0, 0, 4, 15
"c:\Users\bobbo\Documents\GitHub\FoodDynasty\Assets\Dynasty\Library\Events\GenericGameEvent.cs", "C#", 17, 0, 0, 0, 0, 6, 23
"c:\Users\bobbo\Documents\GitHub\FoodDynasty\Assets\Dynasty\Library\Events\InputEvent.cs", "C#", 13, 0, 0, 0, 0, 4, 17
"c:\Users\bobbo\Documents\GitHub\FoodDynasty\Assets\Dynasty\Library\Events\ListEvent.cs", "C#", 37, 0, 0, 0, 0, 12, 49
"c:\Users\bobbo\Documents\GitHub\FoodDynasty\Assets\Dynasty\Library\Events\MouseEventTrigger.cs", "C#", 35, 0, 0, 0, 0, 6, 41
"c:\Users\bobbo\Documents\GitHub\FoodDynasty\Assets\Dynasty\Library\Events\ValueChangedEvent.cs", "C#", 12, 0, 0, 0, 0, 4, 16
"c:\Users\bobbo\Documents\GitHub\FoodDynasty\Assets\Dynasty\Library\Extensions\ComponentExtensions.cs", "C#", 21, 0, 0, 0, 0, 7, 28
"c:\Users\bobbo\Documents\GitHub\FoodDynasty\Assets\Dynasty\Library\Extensions\EnumerableExtensions.cs", "C#", 24, 0, 0, 0, 0, 6, 30
"c:\Users\bobbo\Documents\GitHub\FoodDynasty\Assets\Dynasty\Library\Extensions\MatrixExtensions.cs", "C#", 67, 0, 0, 0, 0, 15, 82
"c:\Users\bobbo\Documents\GitHub\FoodDynasty\Assets\Dynasty\Library\Extensions\VectorExtensions.cs", "C#", 27, 0, 0, 0, 0, 8, 35
"c:\Users\bobbo\Documents\GitHub\FoodDynasty\Assets\Dynasty\Library\Helpers\CanvasHelpers.cs", "C#", 25, 0, 0, 0, 0, 8, 33
"c:\Users\bobbo\Documents\GitHub\FoodDynasty\Assets\Dynasty\Library\Helpers\Colors.cs", "C#", 12, 0, 0, 0, 0, 4, 16
"c:\Users\bobbo\Documents\GitHub\FoodDynasty\Assets\Dynasty\Library\Helpers\CoroutineHelpers.cs", "C#", 15, 0, 0, 0, 0, 4, 19
"c:\Users\bobbo\Documents\GitHub\FoodDynasty\Assets\Dynasty\Library\Helpers\EnumHelpers.cs", "C#", 36, 0, 0, 0, 0, 10, 46
"c:\Users\bobbo\Documents\GitHub\FoodDynasty\Assets\Dynasty\Library\Helpers\MaterialHelpers.cs", "C#", 23, 0, 0, 0, 0, 6, 29
"c:\Users\bobbo\Documents\GitHub\FoodDynasty\Assets\Dynasty\Library\Helpers\MouseHelpers.cs", "C#", 18, 0, 0, 0, 0, 5, 23
"c:\Users\bobbo\Documents\GitHub\FoodDynasty\Assets\Dynasty\Library\Helpers\ReflectionHelpers.cs", "C#", 37, 0, 0, 0, 0, 11, 48
"c:\Users\bobbo\Documents\GitHub\FoodDynasty\Assets\Dynasty\Library\Helpers\StringHelpers.cs", "C#", 47, 0, 0, 0, 0, 6, 53
"c:\Users\bobbo\Documents\GitHub\FoodDynasty\Assets\Dynasty\Library\Helpers\TaskHelpers.cs", "C#", 32, 0, 0, 0, 0, 8, 40
"c:\Users\bobbo\Documents\GitHub\FoodDynasty\Assets\Dynasty\Library\Helpers\UIHelpers.cs", "C#", 15, 0, 0, 0, 0, 4, 19
"c:\Users\bobbo\Documents\GitHub\FoodDynasty\Assets\Dynasty\Library\Misc\InputManager.cs", "C#", 31, 0, 0, 0, 0, 10, 41
"c:\Users\bobbo\Documents\GitHub\FoodDynasty\Assets\Dynasty\Library\Misc\MonoScriptable.cs", "C#", 7, 0, 0, 0, 0, 3, 10
"c:\Users\bobbo\Documents\GitHub\FoodDynasty\Assets\Dynasty\Library\Misc\MonoScriptableRunner.cs", "C#", 14, 0, 0, 0, 0, 5, 19
"c:\Users\bobbo\Documents\GitHub\FoodDynasty\Assets\Dynasty\Library\Misc\Settings.cs", "C#", 109, 0, 0, 0, 0, 23, 132
"c:\Users\bobbo\Documents\GitHub\FoodDynasty\Assets\Dynasty\Library\Misc\TickManager.cs", "C#", 38, 0, 0, 0, 0, 13, 51
"c:\Users\bobbo\Documents\GitHub\FoodDynasty\Assets\Dynasty\Library\Pooling\CustomObjectPool.cs", "C#", 70, 0, 0, 0, 0, 19, 89
"c:\Users\bobbo\Documents\GitHub\FoodDynasty\Assets\Dynasty\Library\Pooling\GenericObjectPool.cs", "C#", 4, 0, 0, 0, 0, 1, 5
"c:\Users\bobbo\Documents\GitHub\FoodDynasty\Assets\Dynasty\Library\Pooling\IPoolable.cs", "C#", 8, 0, 0, 0, 0, 4, 12
"c:\Users\bobbo\Documents\GitHub\FoodDynasty\Assets\Dynasty\Library\Pooling\ParticleSpawner.cs", "C#", 18, 0, 0, 0, 0, 7, 25
"c:\Users\bobbo\Documents\GitHub\FoodDynasty\Assets\Dynasty\Library\Pooling\Poolable.cs", "C#", 12, 0, 0, 0, 0, 5, 17
"c:\Users\bobbo\Documents\GitHub\FoodDynasty\Assets\Dynasty\Library\Pooling\PoolableComponent.cs", "C#", 13, 0, 0, 0, 0, 7, 20
"c:\Users\bobbo\Documents\GitHub\FoodDynasty\Assets\Dynasty\Library\Pooling\RigidbodyObjectPool.cs", "C#", 4, 0, 0, 0, 0, 1, 5
"c:\Users\bobbo\Documents\GitHub\FoodDynasty\Assets\Dynasty\Library\Pooling\SpriteRendererPool.cs", "C#", 4, 0, 0, 0, 0, 1, 5
"c:\Users\bobbo\Documents\GitHub\FoodDynasty\Assets\Dynasty\Library\Pooling\TextObjectPool.cs", "C#", 5, 0, 0, 0, 0, 1, 6
"c:\Users\bobbo\Documents\GitHub\FoodDynasty\Assets\Dynasty\Library\Pooling\UIObjectPool.cs", "C#", 38, 0, 0, 0, 0, 12, 50
"c:\Users\bobbo\Documents\GitHub\FoodDynasty\Assets\Dynasty\Machines\Components\AutoBuyer.cs", "C#", 85, 0, 0, 0, 0, 18, 103
"c:\Users\bobbo\Documents\GitHub\FoodDynasty\Assets\Dynasty\Machines\Components\AutoRefiller.cs", "C#", 158, 0, 0, 0, 0, 41, 199
"c:\Users\bobbo\Documents\GitHub\FoodDynasty\Assets\Dynasty\Machines\Components\BoostableAnimator.cs", "C#", 20, 0, 0, 0, 0, 5, 25
"c:\Users\bobbo\Documents\GitHub\FoodDynasty\Assets\Dynasty\Machines\Components\Booster.cs", "C#", 23, 0, 0, 0, 0, 7, 30
"c:\Users\bobbo\Documents\GitHub\FoodDynasty\Assets\Dynasty\Machines\Components\Conveyor.cs", "C#", 45, 0, 0, 0, 0, 15, 60
"c:\Users\bobbo\Documents\GitHub\FoodDynasty\Assets\Dynasty\Machines\Components\FoodDispenser.cs", "C#", 59, 0, 0, 0, 0, 15, 74
"c:\Users\bobbo\Documents\GitHub\FoodDynasty\Assets\Dynasty\Machines\Components\FoodDisposer.cs", "C#", 8, 0, 0, 0, 0, 3, 11
"c:\Users\bobbo\Documents\GitHub\FoodDynasty\Assets\Dynasty\Machines\Components\FoodEvent.cs", "C#", 3, 0, 0, 0, 0, 1, 4
"c:\Users\bobbo\Documents\GitHub\FoodDynasty\Assets\Dynasty\Machines\Components\FoodMerger.cs", "C#", 104, 0, 0, 0, 0, 21, 125
"c:\Users\bobbo\Documents\GitHub\FoodDynasty\Assets\Dynasty\Machines\Components\FoodModifier.cs", "C#", 29, 0, 0, 0, 0, 8, 37
"c:\Users\bobbo\Documents\GitHub\FoodDynasty\Assets\Dynasty\Machines\Components\FoodSeller.cs", "C#", 26, 0, 0, 0, 0, 7, 33
"c:\Users\bobbo\Documents\GitHub\FoodDynasty\Assets\Dynasty\Machines\Components\FoodSplitter.cs", "C#", 76, 0, 0, 0, 0, 18, 94
"c:\Users\bobbo\Documents\GitHub\FoodDynasty\Assets\Dynasty\Machines\Components\FoodTrigger.cs", "C#", 17, 0, 0, 0, 0, 6, 23
"c:\Users\bobbo\Documents\GitHub\FoodDynasty\Assets\Dynasty\Machines\Components\IMachineComponent.cs", "C#", 6, 0, 0, 0, 0, 3, 9
"c:\Users\bobbo\Documents\GitHub\FoodDynasty\Assets\Dynasty\Machines\Components\MachineModifier.cs", "C#", 98, 0, 0, 0, 0, 26, 124
"c:\Users\bobbo\Documents\GitHub\FoodDynasty\Assets\Dynasty\Machines\Components\SplitConveyor.cs", "C#", 29, 0, 0, 0, 0, 8, 37
"c:\Users\bobbo\Documents\GitHub\FoodDynasty\Assets\Dynasty\Machines\Components\Supply.cs", "C#", 91, 0, 0, 0, 0, 27, 118
"c:\Users\bobbo\Documents\GitHub\FoodDynasty\Assets\Dynasty\Machines\Internal\FilteredFoodEvent.cs", "C#", 65, 0, 0, 0, 0, 15, 80
"c:\Users\bobbo\Documents\GitHub\FoodDynasty\Assets\Dynasty\Machines\Internal\FloatDataProperty.cs", "C#", 11, 0, 0, 0, 0, 5, 16
"c:\Users\bobbo\Documents\GitHub\FoodDynasty\Assets\Dynasty\Machines\Internal\FoodMachineComponent.cs", "C#", 20, 0, 0, 0, 0, 8, 28
"c:\Users\bobbo\Documents\GitHub\FoodDynasty\Assets\Dynasty\Machines\Internal\IBoostable.cs", "C#", 13, 0, 0, 0, 0, 5, 18
"c:\Users\bobbo\Documents\GitHub\FoodDynasty\Assets\Dynasty\Persistent\Core\DiskSaveLoader.cs", "C#", 57, 0, 0, 0, 0, 14, 71
"c:\Users\bobbo\Documents\GitHub\FoodDynasty\Assets\Dynasty\Persistent\Core\SaveInterpreter.cs", "C#", 18, 0, 0, 0, 0, 8, 26
"c:\Users\bobbo\Documents\GitHub\FoodDynasty\Assets\Dynasty\Persistent\Core\SaveLoader.cs", "C#", 11, 0, 0, 0, 0, 4, 15
"c:\Users\bobbo\Documents\GitHub\FoodDynasty\Assets\Dynasty\Persistent\Core\SaveManager.cs", "C#", 63, 0, 0, 0, 0, 20, 83
"c:\Users\bobbo\Documents\GitHub\FoodDynasty\Assets\Dynasty\Persistent\Core\SaveStore.cs", "C#", 22, 0, 0, 0, 0, 9, 31
"c:\Users\bobbo\Documents\GitHub\FoodDynasty\Assets\Dynasty\Persistent\Mapping\AutoSaver.cs", "C#", 24, 0, 0, 0, 0, 7, 31
"c:\Users\bobbo\Documents\GitHub\FoodDynasty\Assets\Dynasty\Persistent\Mapping\InventorySaveInterpreter.cs", "C#", 37, 0, 0, 0, 0, 8, 45
"c:\Users\bobbo\Documents\GitHub\FoodDynasty\Assets\Dynasty\Persistent\Mapping\Lookup.cs", "C#", 16, 0, 0, 0, 0, 6, 22
"c:\Users\bobbo\Documents\GitHub\FoodDynasty\Assets\Dynasty\Persistent\Mapping\MachineLoader.cs", "C#", 89, 0, 0, 0, 0, 19, 108
"c:\Users\bobbo\Documents\GitHub\FoodDynasty\Assets\Dynasty\Persistent\Mapping\MachinesSaveStore.cs", "C#", 33, 0, 0, 0, 0, 8, 41
"c:\Users\bobbo\Documents\GitHub\FoodDynasty\Assets\Dynasty\Persistent\Mapping\MoneySaveInterpreter.cs", "C#", 33, 0, 0, 0, 0, 8, 41
"c:\Users\bobbo\Documents\GitHub\FoodDynasty\Assets\Dynasty\Persistent\Mapping\SerializableVector2Int.cs", "C#", 19, 0, 0, 0, 0, 6, 25
"c:\Users\bobbo\Documents\GitHub\FoodDynasty\Assets\Dynasty\Persistent\Mapping\UnlockSaveInterpreter.cs", "C#", 17, 0, 0, 0, 0, 6, 23
"c:\Users\bobbo\Documents\GitHub\FoodDynasty\Assets\Dynasty\UI\Components\AutoBuyer\AutoBuyerItem.cs", "C#", 37, 0, 0, 0, 0, 10, 47
"c:\Users\bobbo\Documents\GitHub\FoodDynasty\Assets\Dynasty\UI\Components\AutoBuyer\AutoBuyerOverbuyAmount.cs", "C#", 19, 0, 0, 0, 0, 6, 25
"c:\Users\bobbo\Documents\GitHub\FoodDynasty\Assets\Dynasty\UI\Components\AutoRefiller\RefillerStateComponent.cs", "C#", 34, 0, 0, 0, 0, 9, 43
"c:\Users\bobbo\Documents\GitHub\FoodDynasty\Assets\Dynasty\UI\Components\AutoRefiller\RefillerStateController.cs", "C#", 33, 0, 0, 0, 0, 9, 42
"c:\Users\bobbo\Documents\GitHub\FoodDynasty\Assets\Dynasty\UI\Components\Container.cs", "C#", 28, 0, 0, 0, 0, 9, 37
"c:\Users\bobbo\Documents\GitHub\FoodDynasty\Assets\Dynasty\UI\Components\Entity\EntityIcon.cs", "C#", 12, 0, 0, 0, 0, 4, 16
"c:\Users\bobbo\Documents\GitHub\FoodDynasty\Assets\Dynasty\UI\Components\Entity\EntityInfo.cs", "C#", 26, 0, 0, 0, 0, 8, 34
"c:\Users\bobbo\Documents\GitHub\FoodDynasty\Assets\Dynasty\UI\Components\Entity\EntityStatus.cs", "C#", 41, 0, 0, 0, 0, 13, 54
"c:\Users\bobbo\Documents\GitHub\FoodDynasty\Assets\Dynasty\UI\Components\Entity\EntityText.cs", "C#", 17, 0, 0, 0, 0, 5, 22
"c:\Users\bobbo\Documents\GitHub\FoodDynasty\Assets\Dynasty\UI\Components\Info\EntityInfoUIComponent.cs", "C#", 22, 0, 0, 0, 0, 6, 28
"c:\Users\bobbo\Documents\GitHub\FoodDynasty\Assets\Dynasty\UI\Components\Interactable.cs", "C#", 25, 0, 0, 0, 0, 7, 32
"c:\Users\bobbo\Documents\GitHub\FoodDynasty\Assets\Dynasty\UI\Components\ItemData\ItemDataIcon.cs", "C#", 11, 0, 0, 0, 0, 4, 15
"c:\Users\bobbo\Documents\GitHub\FoodDynasty\Assets\Dynasty\UI\Components\ItemData\ItemDataImage.cs", "C#", 11, 0, 0, 0, 0, 4, 15
"c:\Users\bobbo\Documents\GitHub\FoodDynasty\Assets\Dynasty\UI\Components\ItemData\ItemDataInfo.cs", "C#", 4, 0, 0, 0, 0, 3, 7
"c:\Users\bobbo\Documents\GitHub\FoodDynasty\Assets\Dynasty\UI\Components\ItemData\ItemDataOwned.cs", "C#", 21, 0, 0, 0, 0, 6, 27
"c:\Users\bobbo\Documents\GitHub\FoodDynasty\Assets\Dynasty\UI\Components\ItemData\ItemDataPrice.cs", "C#", 12, 0, 0, 0, 0, 4, 16
"c:\Users\bobbo\Documents\GitHub\FoodDynasty\Assets\Dynasty\UI\Components\ItemData\ItemDataTier.cs", "C#", 20, 0, 0, 0, 0, 6, 26
"c:\Users\bobbo\Documents\GitHub\FoodDynasty\Assets\Dynasty\UI\Components\ItemData\ItemUIUtil.cs", "C#", 33, 0, 0, 0, 0, 8, 41
"c:\Users\bobbo\Documents\GitHub\FoodDynasty\Assets\Dynasty\UI\Components\Item\ItemCount.cs", "C#", 11, 0, 0, 0, 0, 4, 15
"c:\Users\bobbo\Documents\GitHub\FoodDynasty\Assets\Dynasty\UI\Components\Item\ItemDataComponent.cs", "C#", 10, 0, 0, 0, 0, 4, 14
"c:\Users\bobbo\Documents\GitHub\FoodDynasty\Assets\Dynasty\UI\Components\Supply\SupplyCurrent.cs", "C#", 18, 0, 0, 0, 0, 6, 24
"c:\Users\bobbo\Documents\GitHub\FoodDynasty\Assets\Dynasty\UI\Components\Supply\SupplyInput.cs", "C#", 42, 0, 0, 0, 0, 15, 57
"c:\Users\bobbo\Documents\GitHub\FoodDynasty\Assets\Dynasty\UI\Components\Supply\SupplyName.cs", "C#", 12, 0, 0, 0, 0, 4, 16
"c:\Users\bobbo\Documents\GitHub\FoodDynasty\Assets\Dynasty\UI\Components\Supply\SupplyOwned.cs", "C#", 16, 0, 0, 0, 0, 5, 21
"c:\Users\bobbo\Documents\GitHub\FoodDynasty\Assets\Dynasty\UI\Components\UIComponent.cs", "C#", 6, 0, 0, 0, 0, 3, 9
"c:\Users\bobbo\Documents\GitHub\FoodDynasty\Assets\Dynasty\UI\Components\UpdatingUIComponent.cs", "C#", 21, 0, 0, 0, 0, 6, 27
"c:\Users\bobbo\Documents\GitHub\FoodDynasty\Assets\Dynasty\UI\Controllers\CloseableWindowController.cs", "C#", 54, 0, 0, 0, 0, 15, 69
"c:\Users\bobbo\Documents\GitHub\FoodDynasty\Assets\Dynasty\UI\Controllers\ControlPanelController.cs", "C#", 63, 0, 0, 0, 0, 14, 77
"c:\Users\bobbo\Documents\GitHub\FoodDynasty\Assets\Dynasty\UI\Controllers\InventoryController.cs", "C#", 105, 0, 0, 0, 0, 26, 131
"c:\Users\bobbo\Documents\GitHub\FoodDynasty\Assets\Dynasty\UI\Controllers\NumberInputController.cs", "C#", 80, 0, 0, 0, 0, 25, 105
"c:\Users\bobbo\Documents\GitHub\FoodDynasty\Assets\Dynasty\UI\Controllers\NumberInputModifier.cs", "C#", 45, 0, 0, 0, 0, 9, 54
"c:\Users\bobbo\Documents\GitHub\FoodDynasty\Assets\Dynasty\UI\Controllers\PopupController.cs", "C#", 67, 0, 0, 0, 0, 15, 82
"c:\Users\bobbo\Documents\GitHub\FoodDynasty\Assets\Dynasty\UI\Controllers\ShopController.cs", "C#", 88, 0, 0, 0, 0, 23, 111
"c:\Users\bobbo\Documents\GitHub\FoodDynasty\Assets\Dynasty\UI\Controllers\TabController.cs", "C#", 93, 0, 0, 0, 0, 27, 120
"c:\Users\bobbo\Documents\GitHub\FoodDynasty\Assets\Dynasty\UI\Controls\ContainerGridObjectControl.cs", "C#", 42, 0, 0, 0, 0, 8, 50
"c:\Users\bobbo\Documents\GitHub\FoodDynasty\Assets\Dynasty\UI\Controls\GridObjectControl.cs", "C#", 8, 0, 0, 0, 0, 3, 11
"c:\Users\bobbo\Documents\GitHub\FoodDynasty\Assets\Dynasty\UI\Controls\GridObjectControls.cs", "C#", 30, 0, 0, 0, 0, 8, 38
"c:\Users\bobbo\Documents\GitHub\FoodDynasty\Assets\Dynasty\UI\Controls\ItemDataBuyControl.cs", "C#", 77, 0, 0, 0, 0, 19, 96
"c:\Users\bobbo\Documents\GitHub\FoodDynasty\Assets\Dynasty\UI\Controls\ItemSellControl.cs", "C#", 79, 0, 0, 0, 0, 18, 97
"c:\Users\bobbo\Documents\GitHub\FoodDynasty\Assets\Dynasty\UI\Displays\FpsDisplay.cs", "C#", 19, 0, 0, 0, 0, 5, 24
"c:\Users\bobbo\Documents\GitHub\FoodDynasty\Assets\Dynasty\UI\Displays\KeybindDisplay.cs", "C#", 17, 0, 0, 0, 0, 5, 22
"c:\Users\bobbo\Documents\GitHub\FoodDynasty\Assets\Dynasty\UI\Displays\KeybindsDisplay.cs", "C#", 30, 0, 0, 0, 0, 9, 39
"c:\Users\bobbo\Documents\GitHub\FoodDynasty\Assets\Dynasty\UI\Displays\MoneyDeltaSpawner.cs", "C#", 41, 0, 0, 0, 0, 13, 54
"c:\Users\bobbo\Documents\GitHub\FoodDynasty\Assets\Dynasty\UI\Displays\MoneyDisplay.cs", "C#", 23, 0, 0, 0, 0, 7, 30
"c:\Users\bobbo\Documents\GitHub\FoodDynasty\Assets\Dynasty\UI\Displays\MoneyPerSecondDisplay.cs", "C#", 36, 0, 0, 0, 0, 9, 45
"c:\Users\bobbo\Documents\GitHub\FoodDynasty\Assets\Dynasty\UI\Displays\SaveDisplay.cs", "C#", 33, 0, 0, 0, 0, 9, 42
"c:\Users\bobbo\Documents\GitHub\FoodDynasty\Assets\Dynasty\UI\Menus\ExitGame.cs", "C#", 19, 0, 0, 0, 0, 4, 23
"c:\Users\bobbo\Documents\GitHub\FoodDynasty\Assets\Dynasty\UI\Menus\MainMenuBackground.cs", "C#", 53, 0, 0, 0, 0, 13, 66
"c:\Users\bobbo\Documents\GitHub\FoodDynasty\Assets\Dynasty\UI\Menus\MainMenuPanorama.cs", "C#", 15, 0, 0, 0, 0, 4, 19
"c:\Users\bobbo\Documents\GitHub\FoodDynasty\Assets\Dynasty\UI\Menus\OptionsMenu.cs", "C#", 67, 0, 0, 0, 0, 16, 83
"c:\Users\bobbo\Documents\GitHub\FoodDynasty\Assets\Dynasty\UI\Menus\PulsingGraphic.cs", "C#", 23, 0, 0, 0, 0, 6, 29
"c:\Users\bobbo\Documents\GitHub\FoodDynasty\Assets\Dynasty\UI\Menus\RotatingCamera.cs", "C#", 9, 0, 0, 0, 0, 4, 13
"c:\Users\bobbo\Documents\GitHub\FoodDynasty\Assets\Dynasty\UI\Menus\SaveSlotContainer.cs", "C#", 32, 0, 0, 0, 0, 10, 42
"c:\Users\bobbo\Documents\GitHub\FoodDynasty\Assets\Dynasty\UI\Menus\SaveSlotController.cs", "C#", 59, 0, 0, 0, 0, 13, 72
"c:\Users\bobbo\Documents\GitHub\FoodDynasty\Assets\Dynasty\UI\Misc\ContainerObjectPool.cs", "C#", 19, 0, 0, 0, 0, 6, 25
"c:\Users\bobbo\Documents\GitHub\FoodDynasty\Assets\Dynasty\UI\Misc\DraggableWindow.cs", "C#", 61, 0, 0, 0, 0, 16, 77
"c:\Users\bobbo\Documents\GitHub\FoodDynasty\Assets\Dynasty\UI\Misc\EnumDropdown.cs", "C#", 45, 0, 0, 0, 0, 12, 57
"c:\Users\bobbo\Documents\GitHub\FoodDynasty\Assets\Dynasty\UI\Misc\KeybindDisplayPool.cs", "C#", 6, 0, 0, 0, 0, 3, 9
"c:\Users\bobbo\Documents\GitHub\FoodDynasty\Assets\Dynasty\UI\Misc\SceneLoader.cs", "C#", 36, 0, 0, 0, 0, 10, 46
"c:\Users\bobbo\Documents\GitHub\FoodDynasty\Assets\Dynasty\UI\Misc\SliderInputField.cs", "C#", 27, 0, 0, 0, 0, 8, 35
"c:\Users\bobbo\Documents\GitHub\FoodDynasty\Assets\Dynasty\UI\Misc\WorldCanvas.cs", "C#", 26, 0, 0, 0, 0, 9, 35
"c:\Users\bobbo\Documents\GitHub\FoodDynasty\Assets\Dynasty\UI\Misc\WorldCanvasRoot.cs", "C#", 14, 0, 0, 0, 0, 6, 20
"c:\Users\bobbo\Documents\GitHub\FoodDynasty\Assets\Dynasty\UI\Misc\WorldCanvasWindow.cs", "C#", 36, 0, 0, 0, 0, 12, 48
"c:\Users\bobbo\Documents\GitHub\FoodDynasty\Assets\Dynasty\UI\Tooltip\InfoTooltip.cs", "C#", 4, 0, 0, 0, 0, 3, 7
"c:\Users\bobbo\Documents\GitHub\FoodDynasty\Assets\Dynasty\UI\Tooltip\InfoTooltipTrigger.cs", "C#", 10, 0, 0, 0, 0, 4, 14
"c:\Users\bobbo\Documents\GitHub\FoodDynasty\Assets\Dynasty\UI\Tooltip\Tooltip.cs", "C#", 67, 0, 0, 0, 0, 19, 86
"c:\Users\bobbo\Documents\GitHub\FoodDynasty\Assets\Dynasty\UI\Tooltip\TooltipTrigger.cs", "C#", 15, 0, 0, 0, 0, 6, 21
"c:\Users\bobbo\Documents\GitHub\FoodDynasty\Assets\Dynasty\UI\Tooltip\TooltipUtil.cs", "C#", 38, 0, 0, 0, 0, 8, 46
"c:\Users\bobbo\Documents\GitHub\FoodDynasty\Assets\Dynasty\UI\Tweening\FadeTweenData.cs", "C#", 27, 0, 0, 0, 0, 6, 33
"c:\Users\bobbo\Documents\GitHub\FoodDynasty\Assets\Dynasty\UI\Tweening\ScaleTweenData.cs", "C#", 16, 0, 0, 0, 0, 5, 21
"c:\Users\bobbo\Documents\GitHub\FoodDynasty\Assets\Dynasty\UI\Tweening\TweenData.cs", "C#", 20, 0, 0, 0, 0, 6, 26
"c:\Users\bobbo\Documents\GitHub\FoodDynasty\Assets\Dynasty\UI\Tweening\UITweenProfile.cs", "C#", 9, 0, 0, 0, 0, 4, 13
"c:\Users\bobbo\Documents\GitHub\FoodDynasty\Assets\Dynasty\UI\Tweening\UITweenProfileEditor.cs", "C#", 22, 0, 0, 0, 0, 9, 31
"c:\Users\bobbo\Documents\GitHub\FoodDynasty\Assets\Dynasty\UI\Tweening\UITweener.cs", "C#", 21, 0, 0, 0, 0, 7, 28
"Total", "-", 14379, 12000, 80, 610, 2709, 9541, 39319